xxxxsxxx
e x    x
xdx xx x
x x  x x
x xx x x
x    xkx
xxxxxxxx

