xxxxxsxxxxx
x      x  x
x xx   x  x
x      x  x
x xxx xxx x
x x x x   x
x x     x x
x x xxxxx x
x   x     x
xxxxxexxxxx
